11111111111111111111111111111111111111111
1P000000000000000000000000000000000000001
10000000000000000000000000000C00000000001
10000000000000000000000000000000000000001
11111111111111111111111110000000001111111
10000000000000000000001110111111111111111
10001111111111100000001110111111111111101
10000000001111111110001110111111111111111
10001111111111111000001110011111111111111
10000111111111111100001100011111111111111
10I00000001111111000001101111111111111111
10000011111111111000000001111111111111111
101000000000000000000E1111111111111111111
11111111111111111111111111111111111111111
