11111111111111111111111111111111111111111
1P000000000000000000000000000000000000001
10000000000000000000000000000C00000000001
10000000000000000000000000000000000000001
10000000000000000000000000000000001111111
10000000000000000000000000111111111111111
10001111111111100000000000111111111111111
10000000001111111110000000111111111111111
10001111111111111000000000011111111111111
10000111111111111100000000011111111111111
10000000001111111000000001111111111111111
10000011111111111000000001111111111111111
101000000000000000000E1111111111111111111
11111111111111111111111111111111111111111
